111111111111111
1100000C10011E1
1000F000C000001
1C00000110C00F1
1C01100F00P0001
1C00000000C0001
111111111111111