111111111111111
110000IC10011E1
1000F000C000001
1C00000110C0IF1
1C00000F00P0001
1C00I00000C0001
111111111111111