111111111111111111111
10000000E1010000000C1
101111111101011111101
1000000CF00C010000001
111101111011110111111
1000000000000101C0001
1011111011110C0111101
101C10001P00101000001
1010101111101010101F1
1000100F0000101010001
101F1011101110101F101
101010001C00001000101
100000F00011F000F11C1
111111111111111111111